暗裔剑魔=Aatrox
九尾妖狐=Ahri
暗影之拳=Akali
影哨=Akshan
牛头酋长=Alistar
殇之木乃伊=Amumu
冰晶凤凰=Anivia
黑暗之女=Annie
残月之肃=Aphelios
铸星龙王=AurelionSol
寒冰射手=Ashe
沙漠皇帝=Azir
星界游神=Bard
蒸汽机器人=Blitzcrank
复仇焰魂=Brand
弗雷尔卓德之心=Braum
皮城女警=Caitlyn
青钢影=Camille
魔蛇之拥=Cassiopeia
虚空恐惧=Chogath
英勇投弹手=Corki
诺克萨斯之手=Darius
皎月女神=Diana
荣耀行刑官=Draven
祖安狂人=DrMundo
时间刺客=Ekko
蜘蛛女皇=Elise
痛苦之拥=Evelynn
探险家=Ezreal
末日使者=Fiddlesticks
无双剑姬=Fiora
潮汐海灵=Fizz
正义巨像=Galio
海洋之灾=Gangplank
德玛西亚之力=Garen
迷失之牙=Gnar
酒桶=Gragas
法外狂徒=Graves
灵罗娃娃=gwen
战争之影=Hecarim
大发明家=Heimerdinger
海兽祭司=Illaoi
刀锋意志=Irelia
翠神=Ivern
风暴之怒=Janna
德玛西亚皇子=JarvanIV
武器大师=Jax
未来守护者=Jayce
戏命师=Jhin
暴走萝莉=Jinx
虚空之女=Kaisa
复仇之矛=Kalista
天启者=Karma
死亡颂唱者=Karthus
虚空行者=Kassadin
不祥之刃=Katarina
审判天使=Kayle
影流之镰=Kayn
狂暴之心=Kennen
永猎双子=Kindred
虚空掠夺者=Khazix
暴怒骑士=Kled
深渊巨口=KogMaw
诡术妖姬=Leblanc
盲僧=LeeSin
曙光女神=Leona
含羞蓓蕾=Lillia
冰霜女巫=Lissandra
圣枪游侠=Lucian
仙灵女巫=Lulu
光辉女郎=Lux
熔岩巨兽=Malphite
虚空先知=Malzahar
扭曲树精=Maokai
无极剑圣=MasterYi
赏金猎人=MissFortune
铁铠冥魂=Mordekaiser
堕落天使=Morgana
齐天大圣=MonkeyKing
唤潮鲛姬=Nami
沙漠死神=Nasus
深海泰坦=Nautilus
万花通灵=Neeko
狂野女猎手=Nidalee
永恒梦魇=Nocturne
雪人骑士=Nunu
狂战士=Olaf
发条魔灵=Orianna
山隐之焰=Ornn
战争之王=Pantheon
圣锤之毅=Poppy
血港鬼影=Pyke
元素女皇=Qiyana
德玛西亚之翼=Quinn
幻翎=Rakan
披甲龙龟=Rammus
虚空遁地兽=RekSai
镕铁少女=Rell
荒漠屠夫=Renekton
傲之追猎者=Rengar
放逐之刃=Riven
机械公敌=Rumble
符文法师=Ryze
沙漠玫瑰=Samira
北地之怒=Sejuani
星籁歌姬=Seraphine
涤魂圣枪=Senna
腕豪=Sett
恶魔小丑=Shaco
暮光之眼=Shen
龙血武姬=Shyvana
炼金术士=Singed
亡灵战神=Sion
战争女神=Sivir
水晶先锋=Skarner
琴瑟仙女=Sona
众星之子=Soraka
诺克萨斯统领=Swain
解脱者=Sylas
暗黑元首=Syndra
河流之王=TahmKench
岩雀=Taliyah
刀锋之影=Talon
瓦洛兰之盾=Taric
迅捷斥候=Teemo
魂锁典狱长=Thresh
麦林炮手=Tristana
巨魔之王=Trundle
蛮族之王=Tryndamere
卡牌大师=TwistedFate
瘟疫之源=Twitch
兽灵行者=Udyr
无畏战车=Urgot
惩戒之箭=Varus
暗夜猎手=Vayne
邪恶小法师=Veigar
虚空之眼=Velkoz
皮城执法官=Vi
破败之王=Viego
机械先驱=Viktor
猩红收割者=Vladimir
雷霆咆哮=Volibear
祖安怒兽=Warwick
逆羽=Xayah
远古巫灵=Xerath
德邦总管=XinZhao
疾风剑豪=Yasuo
魔法猫咪=Yuumi
封魔剑魂=Yone
牧魂人=Yorick
生化魔人=Zac
影流之主=Zed
爆破鬼才=Ziggs
时光守护者=Zilean
暮光星灵=Zoe
荆棘之兴=Zyra